11111111111111111
100000P0000000C11
10000E00000000001
11111111111111111