111111111111111111111
1P0000000000000C00001
1000000000000000000E1
111111111111111111111
