111111111111111111111
111111111111111111111
111111111111111111111
111111111111111111111
11C000P000000E0000M11
10000000000000000MM01
10000000000000000MM01
10000000000000000MM01
10000000000000000MM01
10000000000000000MM01
10000000000000000MM01
10000000000000000MM01
10000000000000000MM01
10000000000000000MM01
10000000000000000MM01
10000000000000000MM01
10000000000000000MM01
10000000000000000MM01
10000000000000000MM01
10000000000000000MM01
10000000000000000MM01
10000000000000000MM01
10000000000000000MM01
10000000000000000MM01
10000000000000000MM01
10000000000000000MM01
10000000000000000MM01
10000000000000000MM01
10000000000000000MM01
10000000000000000MM01
111111111111111111111
