1111111111111111111111111
10E01000M000000000M000001
101001000010000M101001001
1111010010101010001M00001
1PC00000000000C10M0000001
1111111111111111111111111
